VVV#####VVVVVVV####VVV
VVV#   #VVVVVVV#  #VVV
VVV### ######### #####
####                 #
#  #                 #
## ### ######### P####
#                PVVVV
#  O             PVVVV
# ############ P##VVVV
# ###          PVVVVVV
# ###        # PVVVVVV
# ###    ##### PVVVVVV
#  #           PVVVVVV
#  I           PVVVVVV
################VVVVVV
