VVVVVVVV###################
VVVVVVVV##                 #
VVVVVVVV#I                 #
VVVVV#######         ##    #
VVVVV#                     #
VVVVV#        #         O  #
########TTT ###    #  ######
#     TTT ##VV#   ##  #VVVVV
##########VVVV#  #V#  #VVVVV
VVVVVVVVVVVVVV###VV####VVVVV
