############################
##                         #
#I                         #
####             #    ######
VVV#             #   ##VVVVV
VVV#TT TTTTTTTTTT   ##VVVVVV
VVV#TTTTTTTTTTTT  O##VVVVVVV
VVV#####   #########VVVVVVVV
VVVVVVV#         #VVVVVVVVVV
VVVVVVV#    P#####VVVVVVVVVV
VVVVVVV#    PVVVVVVVVVVVVVVV
VVVVVVV######VVVVVVVVVVVVVVV
