########
#      #
#     O#
#    ###
##   #VV
#I   #VV
######VV
