#################
#               #
##         ######
#I         ##############
######                  #
#    ##      TTT       O#
####  ############   ##############
#                                 #
#                                 #
###########################       #
VVVVVVVVVVVVVVVVVVVVVVVVVV#########
