##########
#        #
##       #
#I    #  #
#######  #
Vv#      #
VV#      #
VV#  O   #
VV########
0123456789
